1 1 1 1 1 1 1 1 1 1 1 1 1 1 1 1 1 1 1 1
1 8 8 8 8 4 4 7 7 5 7 7 7 7 6 6 6 7 5 1
1 8 8 8 8 4 4 7 7 7 7 7 7 6 6 6 7 7 7 1
1 8 4 4 4 4 4 7 5 7 7 7 6 6 6 7 7 7 7 1
1 4 4 7 7 6 6 6 6 6 6 6 6 6 6 7 7 7 7 1
1 7 7 7 7 6 6 6 6 6 6 6 7 7 7 5 5 7 7 1
1 7 7 7 5 6 6 7 7 7 7 1 1 1 3 3 1 7 7 1
1 5 7 0 6 1 6 0 0 0 7 3 3 3 3 3 1 7 7 1
1 7 0 0 6 6 6 0 0 0 7 3 3 3 3 3 2 7 7 1
1 0 0 0 6 6 0 0 0 0 7 1 3 3 3 3 2 7 7 1
1 0 0 1 6 0 0 0 0 7 7 1 3 3 3 3 1 7 7 1
1 0 0 6 6 6 0 0 0 4 4 1 1 1 3 3 1 7 7 1
1 0 0 1 6 1 0 0 4 8 8 8 8 8 4 4 7 7 7 1
1 0 0 6 6 0 0 0 4 8 8 8 8 8 4 4 4 4 7 1
1 0 0 6 6 0 0 0 4 8 8 4 4 4 4 4 4 4 4 1
1 0 0 6 6 1 1 2 2 1 1 1 4 4 4 4 4 4 8 1
1 0 0 6 6 1 3 3 3 3 3 1 4 4 4 8 8 8 8 1
1 0 0 6 6 3 3 3 3 1 3 3 4 4 4 8 8 8 8 1
1 0 0 6 6 3 3 3 3 1 3 3 4 4 4 8 8 8 8 1
1 1 1 1 1 1 1 1 1 1 1 1 1 1 1 1 1 1 1 1